7 7
+ +-+-+-+-+-+-+
| |           |
+ +-+-+-+-+-+ +
|         |   |
+-+-+-+-+ + +-+
|       | |   |
+ +-+ + + +-+ +
| |   | |   | |
+ + +-+-+-+ + +
| |   |     | |
+ +-+ + +-+-+ +
| | | | |     |
+ + + + +-+ + +
|   |       | |
+-+-+-+-+-+-+ +

BFS:
+ +-+-+-+-+-+-+
|0|           |
+ +-+-+-+-+-+ +
|1 2 3 4 5|   |
+-+-+-+-+ + +-+
|       |6|   |
+ +-+ + + +-+ +
| |   | |7 8| |
+ + +-+-+-+ + +
| |2 9|1 0 9|3|
+ +-+ + +-+-+ +
| | |7|2|1 8 0|
+ + + + +-+ + +
|   |5 3 4 6|4|
+-+-+-+-+-+-+ +

+ +-+-+-+-+-+-+
|#|           |
+ +-+-+-+-+-+ +
|# # # # #|   |
+-+-+-+-+ + +-+
|       |#|   |
+ +-+ + + +-+ +
| |   | |# #| |
+ + +-+-+-+ + +
| |   |# # #| |
+ +-+ + +-+-+ +
| | | |#|  # #|
+ + + + +-+ + +
|   |  # # #|#|
+-+-+-+-+-+-+ +
Path: (0, 0) (0, 1) (1, 1) (2, 1) (3, 1) (4, 1) (4, 2) (4, 3) (5, 3) (5, 4) (4, 4) (3, 4) (3, 5) (3, 6) (4, 6) (5, 6) (5, 5) (6, 5) (6, 6) 
Length of path: 19
Visited cells: 25

DFS:
+ +-+-+-+-+-+-+
|0|           |
+ +-+-+-+-+-+ +
|1 2 3 4 5|   |
+-+-+-+-+ + +-+
|2 1 0 9|6|   |
+ +-+ + + +-+ +
|3|8 9|0|7 8| |
+ + +-+-+-+ + +
|4|7 6|1 0 9| |
+ +-+ + +-+-+ +
|5|8|5|2|4 3 5|
+ + + + +-+ + +
|6 7|4 3 1 2|6|
+-+-+-+-+-+-+ +

+ +-+-+-+-+-+-+
|#|           |
+ +-+-+-+-+-+ +
|# # # # #|   |
+-+-+-+-+ + +-+
|       |#|   |
+ +-+ + + +-+ +
| |   | |# #| |
+ + +-+-+-+ + +
| |   |# # #| |
+ +-+ + +-+-+ +
| | | |#|  # #|
+ + + + +-+ + +
|   |  # # #|#|
+-+-+-+-+-+-+ +
Path: (0, 0) (0, 1) (1, 1) (2, 1) (3, 1) (4, 1) (4, 2) (4, 3) (5, 3) (5, 4) (4, 4) (3, 4) (3, 5) (3, 6) (4, 6) (5, 6) (5, 5) (6, 5) (6, 6) 
Length of path: 19
Visited cells: 37

