9 9
+ +-+-+-+-+-+-+-+-+
| |     |   |     |
+ + +-+ + + + +-+ +
| | |   | |   |   |
+ + + +-+-+-+ + + +
|   | |     | | | |
+-+-+ + +-+ + + +-+
|   |   |   | |   |
+ + +-+-+ +-+ +-+ +
| |       | | |   |
+ +-+-+-+-+ + + +-+
|     |       |   |
+-+-+ +-+-+ +-+-+ +
|   |     | |     |
+ +-+-+-+ +-+ +-+ +
|       |     | | |
+ +-+-+ +-+-+-+ + +
|     |           |
+-+-+-+-+-+-+-+-+ +

