9 9
+ +-+-+-+-+-+-+-+-+
| |     |   |     |
+ + +-+ + + + +-+ +
| | |   | |   |   |
+ + + +-+-+-+ + + +
|   | |     | | | |
+-+-+ + +-+ + + +-+
|   |   |   | |   |
+ + +-+-+ +-+ +-+ +
| |       | | |   |
+ +-+-+-+-+ + + +-+
|     |       |   |
+-+-+ +-+-+ +-+-+ +
|   |     | |     |
+ +-+-+-+ +-+ +-+ +
|       |     | | |
+ +-+-+ +-+-+-+ + +
|     |           |
+-+-+-+-+-+-+-+-+ +

BFS:
+ +-+-+-+-+-+-+-+-+
|0|5 6 7|   |     |
+ + +-+ + + + +-+ +
|1|4|9 8| |   |   |
+ + + +-+-+-+ + + +
|2 3|0|3 4 5| | | |
+-+-+ + +-+ + + +-+
|3 2|1 2|7 6| |   |
+ + +-+-+ +-+ +-+ +
|4|1 0 9 8| | |   |
+ +-+-+-+-+ + + +-+
|5 6 7|       |9 7|
+-+-+ +-+-+ +-+-+ +
|   |8 9 0| |4 5 6|
+ +-+-+-+ +-+ +-+ +
|       |1 2 3| |8|
+ +-+-+ +-+-+-+ + +
|     |          0|
+-+-+-+-+-+-+-+-+ +

+ +-+-+-+-+-+-+-+-+
|#|# # #|   |     |
+ + +-+ + + + +-+ +
|#|#|# #| |   |   |
+ + + +-+-+-+ + + +
|# #|#|# # #| | | |
+-+-+ + +-+ + + +-+
|# #|# #|# #| |   |
+ + +-+-+ +-+ +-+ +
|#|# # # #| | |   |
+ +-+-+-+-+ + + +-+
|# # #|       |   |
+-+-+ +-+-+ +-+-+ +
|   |# # #| |# # #|
+ +-+-+-+ +-+ +-+ +
|       |# # #| |#|
+ +-+-+ +-+-+-+ + +
|     |          #|
+-+-+-+-+-+-+-+-+ +
Path: (0, 0) (0, 1) (0, 2) (1, 2) (1, 1) (1, 0) (2, 0) (3, 0) (3, 1) (2, 1) (2, 2) (2, 3) (3, 3) (3, 2) (4, 2) (5, 2) (5, 3) (4, 3) (4, 4) (3, 4) (2, 4) (1, 4) (1, 3) (0, 3) (0, 4) (0, 5) (1, 5) (2, 5) (2, 6) (3, 6) (4, 6) (4, 7) (5, 7) (6, 7) (6, 6) (7, 6) (8, 6) (8, 7) (8, 8) 
Length of path: 39
Visited cells: 41

DFS:
+ +-+-+-+-+-+-+-+-+
|0|5 6 7|   |     |
+ + +-+ + + + +-+ +
|1|4|9 8| |   |   |
+ + + +-+-+-+ + + +
|2 3|0|3 4 5| | | |
+-+-+ + +-+ + + +-+
|3 2|1 2|7 6| |   |
+ + +-+-+ +-+ +-+ +
|4|1 0 9 8| | |   |
+ +-+-+-+-+ + + +-+
|5 6 7|       |   |
+-+-+ +-+-+ +-+-+ +
|   |8 9 0| |4 5 6|
+ +-+-+-+ +-+ +-+ +
|       |1 2 3| |7|
+ +-+-+ +-+-+-+ + +
|     |          8|
+-+-+-+-+-+-+-+-+ +

+ +-+-+-+-+-+-+-+-+
|#|# # #|   |     |
+ + +-+ + + + +-+ +
|#|#|# #| |   |   |
+ + + +-+-+-+ + + +
|# #|#|# # #| | | |
+-+-+ + +-+ + + +-+
|# #|# #|# #| |   |
+ + +-+-+ +-+ +-+ +
|#|# # # #| | |   |
+ +-+-+-+-+ + + +-+
|# # #|       |   |
+-+-+ +-+-+ +-+-+ +
|   |# # #| |# # #|
+ +-+-+-+ +-+ +-+ +
|       |# # #| |#|
+ +-+-+ +-+-+-+ + +
|     |          #|
+-+-+-+-+-+-+-+-+ +
Path: (0, 0) (0, 1) (0, 2) (1, 2) (1, 1) (1, 0) (2, 0) (3, 0) (3, 1) (2, 1) (2, 2) (2, 3) (3, 3) (3, 2) (4, 2) (5, 2) (5, 3) (4, 3) (4, 4) (3, 4) (2, 4) (1, 4) (1, 3) (0, 3) (0, 4) (0, 5) (1, 5) (2, 5) (2, 6) (3, 6) (4, 6) (4, 7) (5, 7) (6, 7) (6, 6) (7, 6) (8, 6) (8, 7) (8, 8) 
Length of path: 39
Visited cells: 39

