5 5
+ +-+-+-+-+
|   |     |
+-+ + +-+ +
| |   |   |
+ +-+-+ +-+
|   |   | |
+ +-+ +-+ +
| |   |   |
+ + +-+ + +
|       | |
+-+-+-+-+ +

