7 7
+ +-+-+-+-+-+-+
| |           |
+ +-+-+-+-+-+ +
|         |   |
+-+-+-+-+ + +-+
|       | |   |
+ +-+ + + +-+ +
| |   | |   | |
+ + +-+-+-+ + +
| |   |     | |
+ +-+ + +-+-+ +
| | | | |     |
+ + + + +-+ + +
|   |       | |
+-+-+-+-+-+-+ +

