8 8
+ +-+-+-+-+-+-+-+
|   |         | |
+-+ +-+-+-+ + + +
| |       | |   |
+ +-+-+-+ + +-+ +
|   |   |   |   |
+ + + + +-+-+ +-+
| |   | |     | |
+ +-+-+-+ +-+-+ +
|         |   | |
+ +-+-+-+-+ + + +
| |     |   | | |
+ + +-+ + +-+ + +
| | | | | |   | |
+ + + + + + +-+ +
|   |     |     |
+-+-+-+-+-+-+-+ +



