20 20
+ +-+-+-+-+-+-+-+-+-+-+-+-+-+-+-+-+-+-+-+
| |     |   |       | | |     |     |   |
+ + + + + +-+-+-+ + + + +-+ +-+-+ +-+-+ +
|   | |   |   |   |   | | |       |     |
+-+-+ +-+ + + +-+ + +-+ + + +-+-+ + + + +
|   | |   | | |   |   |         |   | | |
+-+ +-+-+ + +-+ +-+-+ +-+-+-+-+-+ + +-+ +
| | |             | |     |       | |   |
+ + + +-+ +-+-+-+-+ +-+ +-+-+ +-+-+ +-+-+
| |     |   |     |           |   | |   |
+ +-+-+ +-+-+-+ +-+-+-+ + +-+-+ +-+-+ +-+
| |   |     | |         |   | | |   |   |
+ +-+ + + +-+ + +-+-+-+ +-+-+ + + +-+-+ +
|   | | |   |       | | |     |         |
+ +-+ +-+-+-+ +-+-+-+ +-+ +-+ + +-+ +-+-+
|     | | |   |   | |   | |   | | | |   |
+-+ + + + + +-+-+ + +-+ + +-+ + + + + +-+
|   |   |                 | |   |     | |
+-+ +-+ + +-+ +-+-+-+ +-+-+ +-+ + +-+-+ +
|   |     | |   |           |   | |     |
+-+-+ + +-+ +-+-+ +-+-+ + +-+-+ + +-+ + +
| |   | |   |     | |   | |     | |   | |
+ + +-+-+ +-+ +-+ + +-+-+ +-+-+-+ +-+ +-+
|   | |       |   | |         | |   | | |
+ +-+ + +-+ +-+ +-+ +-+ + +-+-+ +-+-+ + +
| |       |   |   |   | | |       | |   |
+ + + +-+-+ +-+-+-+ +-+-+ + +-+-+ + + +-+
| | | | |   |   |   | | | |   |       | |
+-+-+-+ +-+ +-+ +-+ + + + + +-+-+ +-+ + +
| |   |           | |         |     |   |
+ + + +-+-+-+-+ + + + +-+ +-+ +-+ +-+ + +
| | |           | |   | |   |   |   | | |
+ +-+ +-+-+ + +-+ + + + + +-+ +-+-+ + +-+
|     | |   | | | | | |   | | | |   | | |
+ + + + +-+-+ + + +-+-+-+-+ + + + +-+-+ +
| | | |   |     | |           | |   |   |
+ +-+ + + + +-+ +-+ +-+-+-+ + + +-+-+ + +
|   | | |   |     | |       |         | |
+-+ + + + + +-+-+ +-+-+ +-+ + + +-+-+ + +
|   | | | |   |     |   |   | | |     | |
+-+-+-+-+-+-+-+-+-+-+-+-+-+-+-+-+-+-+-+ +

