20 20
+ +-+-+-+-+-+-+-+-+-+-+-+-+-+-+-+-+-+-+-+
| |     |   |       | | |     |     |   |
+ + + + + +-+-+-+ + + + +-+ +-+-+ +-+-+ +
|   | |   |   |   |   | | |       |     |
+-+-+ +-+ + + +-+ + +-+ + + +-+-+ + + + +
|   | |   | | |   |   |         |   | | |
+-+ +-+-+ + +-+ +-+-+ +-+-+-+-+-+ + +-+ +
| | |             | |     |       | |   |
+ + + +-+ +-+-+-+-+ +-+ +-+-+ +-+-+ +-+-+
| |     |   |     |           |   | |   |
+ +-+-+ +-+-+-+ +-+-+-+ + +-+-+ +-+-+ +-+
| |   |     | |         |   | | |   |   |
+ +-+ + + +-+ + +-+-+-+ +-+-+ + + +-+-+ +
|   | | |   |       | | |     |         |
+ +-+ +-+-+-+ +-+-+-+ +-+ +-+ + +-+ +-+-+
|     | | |   |   | |   | |   | | | |   |
+-+ + + + + +-+-+ + +-+ + +-+ + + + + +-+
|   |   |                 | |   |     | |
+-+ +-+ + +-+ +-+-+-+ +-+-+ +-+ + +-+-+ +
|   |     | |   |           |   | |     |
+-+-+ + +-+ +-+-+ +-+-+ + +-+-+ + +-+ + +
| |   | |   |     | |   | |     | |   | |
+ + +-+-+ +-+ +-+ + +-+-+ +-+-+-+ +-+ +-+
|   | |       |   | |         | |   | | |
+ +-+ + +-+ +-+ +-+ +-+ + +-+-+ +-+-+ + +
| |       |   |   |   | | |       | |   |
+ + + +-+-+ +-+-+-+ +-+-+ + +-+-+ + + +-+
| | | | |   |   |   | | | |   |       | |
+-+-+-+ +-+ +-+ +-+ + + + + +-+-+ +-+ + +
| |   |           | |         |     |   |
+ + + +-+-+-+-+ + + + +-+ +-+ +-+ +-+ + +
| | |           | |   | |   |   |   | | |
+ +-+ +-+-+ + +-+ + + + + +-+ +-+-+ + +-+
|     | |   | | | | | |   | | | |   | | |
+ + + + +-+-+ + + +-+-+-+-+ + + + +-+-+ +
| | | |   |     | |           | |   |   |
+ +-+ + + + +-+ +-+ +-+-+-+ + + +-+-+ + +
|   | | |   |     | |       |         | |
+-+ + + + + +-+-+ +-+-+ +-+ + + +-+-+ + +
|   | | | |   |     |   |   | | |     | |
+-+-+-+-+-+-+-+-+-+-+-+-+-+-+-+-+-+-+-+ +

BFS:
+ +-+-+-+-+-+-+-+-+-+-+-+-+-+-+-+-+-+-+-+
|0|3 4 6|0 2|7 4 8 3|1|9|4 6 3|3 7 2|7 8|
+ + + + + +-+-+-+ + + + +-+ +-+-+ +-+-+ +
|1 2|5|8 9|2 5|9 4|6 9|4|5|9 4 8 4|9 5 1|
+-+-+ +-+ + + +-+ + +-+ + + +-+-+ + + + +
|2 7|7|4 1|9|0|6 1|8 0|6 6 7 5 4|0 5|0|9|
+-+ +-+-+ + +-+ +-+-+ +-+-+-+-+-+ + +-+ +
|2|3|1 7 3 6 0 3 7|7|2 3 5|2 9 1 5|0|7 8|
+ + + +-+ +-+-+-+-+ +-+ +-+-+ +-+-+ +-+-+
|3|9 4 8|5 8|7 3 6|3 8 4 7 2 6|2 6|6|2 7|
+ +-+-+ +-+-+-+ +-+-+-+ + +-+-+ +-+-+ +-+
|4|2 2|2 6 1|2|0 8 4 0 6|1 5|0|0|3 7|8 9|
+ +-+ + + +-+ + +-+-+-+ +-+-+ + + +-+-+ +
|5 5|4|5|0 5|9 4 8 1|0|9|1 2 2|6 1 4 9 2|
+ +-+ +-+-+-+ +-+-+-+ +-+ +-+ + +-+ +-+-+
|4 5 7|1|4|6 3|8 9|9|0 2|1|7 1|4|6|8|5 0|
+-+ + + + + +-+-+ + +-+ + +-+ + + + + +-+
|4 3|2 1|8 1 7 3 1 0 0 6 3|9|6 3|8 1 7| |
+-+ +-+ + +-+ +-+-+-+ +-+-+ +-+ + +-+-+ +
|3 3|3 2 5|7|2 0|9 1 5 0 8 8|8 5|7|8 4 7|
+-+-+ + +-+ +-+-+ +-+-+ + +-+-+ + +-+ + +
|6|8 3|2|2 4|1 1 9|0|6 7|7|5 2 7|1|5 9| |
+ + +-+-+ +-+ +-+ + +-+-+ +-+-+-+ +-+ +-+
|5 6|9|3 2 5 9|0 0|2|7 9 8 8 5|6|6 2|4|0|
+ +-+ + +-+ +-+ +-+ +-+ + +-+-+ +-+-+ + +
|7|1 9 5 8|1 1|8 4|6 3|6|7|7 0 3 7|3|0 5|
+ + + +-+-+ +-+-+-+ +-+-+ + +-+-+ + + +-+
|6|5|0|4|3 0|8 1|7 0|0|8|4|6 8|5 0 4 4|2|
+-+-+-+ +-+ +-+ +-+ + + + + +-+-+ +-+ + +
| |3 0|8 6 2 5 7 3|5|9 0 3 9 7|2 3 1|1 7|
+ + + +-+-+-+-+ + + + +-+ +-+ +-+ +-+ + +
| | |5 9 3 5 9 2|0|4 1|9|8 5|9 2|0 9|6|3|
+ +-+ +-+-+ + +-+ + + + + +-+ +-+-+ + +-+
|  5 1| |8 2|4|2|6|6|3|6 4|3|1|5|8 3|1|6|
+ + + + +-+-+ + + +-+-+-+-+ + + + +-+-+ +
| | |4|  1|7 1 6|4|5 9 1 5 9 4|6|3 6|8 4|
+ +-+ + + + +-+ +-+ +-+-+-+ + + +-+-+ + +
|   | | |9 4|7 3 6|1|4 8 0 4|8 2 8 6 2|7|
+-+ + + + + +-+-+ +-+-+ +-+ + + +-+-+ + +
|   | | |2|8 0|  9  |0 3|7 9|1|7|8 5 9|9|
+-+-+-+-+-+-+-+-+-+-+-+-+-+-+-+-+-+-+-+ +

+ +-+-+-+-+-+-+-+-+-+-+-+-+-+-+-+-+-+-+-+
|#|# # #|   |    # #| | |     |     |   |
+ + + + + +-+-+-+ + + + +-+ +-+-+ +-+-+ +
|# #| |# #|   |  #|#  | | |       |     |
+-+-+ +-+ + + +-+ + +-+ + + +-+-+ + + + +
|   | |  #| | |# #|# #|         |   | | |
+-+ +-+-+ + +-+ +-+-+ +-+-+-+-+-+ + +-+ +
| | |    # # # #  | |# #  |       | |   |
+ + + +-+ +-+-+-+-+ +-+ +-+-+ +-+-+ +-+-+
| |     |   |     |    #      |   | |   |
+ +-+-+ +-+-+-+ +-+-+-+ + +-+-+ +-+-+ +-+
| |   |     | |# # # # #|   | | |   |   |
+ +-+ + + +-+ + +-+-+-+ +-+-+ + + +-+-+ +
|   | | |   |# #    | | |     |         |
+ +-+ +-+-+-+ +-+-+-+ +-+ +-+ + +-+ +-+-+
|     | | |# #|   | |   | |   | | | |   |
+-+ + + + + +-+-+ + +-+ + +-+ + + + + +-+
|   |   |  # # # # # #    | |   |     | |
+-+ +-+ + +-+ +-+-+-+ +-+-+ +-+ + +-+-+ +
|   |     | |   |    # # #  |   | |     |
+-+-+ + +-+ +-+-+ +-+-+ + +-+-+ + +-+ + +
| |   | |   |     | |   |#|     | |   | |
+ + +-+-+ +-+ +-+ + +-+-+ +-+-+-+ +-+ +-+
|   | |       |   | |    #    | |   | | |
+ +-+ + +-+ +-+ +-+ +-+ + +-+-+ +-+-+ + +
| |       |   |   |   | |#|       | |   |
+ + + +-+-+ +-+-+-+ +-+-+ + +-+-+ + + +-+
| | | | |   |   |   | | |#|   |       | |
+-+-+-+ +-+ +-+ +-+ + + + + +-+-+ +-+ + +
| |   |           | |    # # #|     |   |
+ + + +-+-+-+-+ + + + +-+ +-+ +-+ +-+ + +
| | |           | |   | |   |#  |   | | |
+ +-+ +-+-+ + +-+ + + + + +-+ +-+-+ + +-+
|     | |   | | | | | |   | |#| |   | | |
+ + + + +-+-+ + + +-+-+-+-+ + + + +-+-+ +
| | | |   |     | |          #| |   |# #|
+ +-+ + + + +-+ +-+ +-+-+-+ + + +-+-+ + +
|   | | |   |     | |       |# # # # #|#|
+-+ + + + + +-+-+ +-+-+ +-+ + + +-+-+ + +
|   | | | |   |     |   |   | | |     |#|
+-+-+-+-+-+-+-+-+-+-+-+-+-+-+-+-+-+-+-+ +
Path: (0, 0) (0, 1) (1, 1) (1, 0) (2, 0) (3, 0) (3, 1) (4, 1) (4, 2) (4, 3) (5, 3) (6, 3) (7, 3) (7, 2) (8, 2) (8, 1) (8, 0) (9, 0) (9, 1) (9, 2) (10, 2) (10, 3) (11, 3) (11, 4) (11, 5) (10, 5) (9, 5) (8, 5) (7, 5) (7, 6) (6, 6) (6, 7) (5, 7) (5, 8) (6, 8) (7, 8) (8, 8) (9, 8) (10, 8) (10, 9) (11, 9) (12, 9) (12, 10) (12, 11) (12, 12) (12, 13) (12, 14) (13, 14) (14, 14) (14, 15) (14, 16) (14, 17) (14, 18) (15, 18) (16, 18) (17, 18) (18, 18) (18, 17) (19, 17) (19, 18) (19, 19) 
Length of path: 61
Visited cells: 380

DFS:
+ +-+-+-+-+-+-+-+-+-+-+-+-+-+-+-+-+-+-+-+
|0|3 4 5|   |5 4 3 6|9|7|2 1 3|5 4 6|7 6|
+ + + + + +-+-+-+ + + + +-+ +-+-+ +-+-+ +
|1 2| |6 7|   |2 1|7 8|6|8|2 1 0 9|0 1 2|
+-+-+ +-+ + + +-+ + +-+ + + +-+-+ + + + +
|7 6| |9 8| | |9 0|0 1|5 4 3 9 0|6 7|8|3|
+-+ +-+-+ + +-+ +-+-+ +-+-+-+-+-+ + +-+ +
|0|5|2 1 0 5 6 7 8|8|2 3 4|3 2 4 5|8|5 4|
+ + + +-+ +-+-+-+-+ +-+ +-+-+ +-+-+ +-+-+
|9|4 3 8|   |     |7 6 5 9 0 1|4 5|9|8 9|
+ +-+-+ +-+-+-+ +-+-+-+ + +-+-+ +-+-+ +-+
|8|7 6|9 0 1| |3 2 1 0 9|7 8|6|3|1 2|7 6|
+ +-+ + + +-+ + +-+-+-+ +-+-+ + + +-+-+ +
|6 7|5|4|2 3|5 4    |9| |8 9 0|1 2 3 4 5|
+ +-+ +-+-+-+ +-+-+-+ +-+ +-+ + +-+ +-+-+
|5 4 3|8|9|7 6|   | |8 7|7|2 1|0|7|0|9 0|
+-+ + + + + +-+-+ + +-+ + +-+ + + + + +-+
|2 1|2 1|9 8 0 1 2 3 4 5 6|9|3 4|2 1 8| |
+-+ +-+ + +-+ +-+-+-+ +-+-+ +-+ + +-+-+ +
|4 3|2 1 0|9|   |2 1 0 6 7 8|6 5|3|     |
+-+-+ + +-+ +-+-+ +-+-+ + +-+-+ + +-+ + +
|9|4 3|0|7 8|5 4 3|1|   |0|9 8 7|4|   | |
+ + +-+-+ +-+ +-+ + +-+-+ +-+-+-+ +-+ +-+
|6 5|5|9 8 7 6|3 2|0|3 2 1 5 6| |5 6| | |
+ +-+ + +-+ +-+ +-+ +-+ + +-+-+ +-+-+ + +
|7|2 1 0 6|0 1|4 5|8 9|4|7|       | |   |
+ + + +-+-+ +-+-+-+ +-+-+ + +-+-+ + + +-+
|8|3|4|7|3 2|1 0|7 6|3|4|8|   |       | |
+-+-+-+ +-+ +-+ +-+ + + + + +-+-+ +-+ + +
|9|5 4|6 5 4 8 9 0|5|1 0 9 5 6|     |   |
+ + + +-+-+-+-+ + + + +-+ +-+ +-+ +-+ + +
|8|6|9 8 7 6 5 4|1|3 2| |   |7 8|   | | |
+ +-+ +-+-+ + +-+ + + + + +-+ +-+-+ + +-+
|2 1 0|9|8 7|9|9|2|4|2|   |5|9| |   | | |
+ + + + +-+-+ + + +-+-+-+-+ + + + +-+-+ +
|3|0|1|6 5|1 0 2|3|5 4 3 2 1 0| |   |4 5|
+ +-+ + + + +-+ +-+ +-+-+-+ + + +-+-+ + +
|4 5|2|7|3 2|4 3 5|6|0 9 8 7|6 7 8 9 0|6|
+-+ + + + + +-+-+ +-+-+ +-+ + + +-+-+ + +
|7 6|3|8|4|0 1|7 6 8|2 1|4 3| | |3 2 1|7|
+-+-+-+-+-+-+-+-+-+-+-+-+-+-+-+-+-+-+-+ +

+ +-+-+-+-+-+-+-+-+-+-+-+-+-+-+-+-+-+-+-+
|#|# # #|   |    # #| | |     |     |   |
+ + + + + +-+-+-+ + + + +-+ +-+-+ +-+-+ +
|# #| |# #|   |  #|#  | | |       |     |
+-+-+ +-+ + + +-+ + +-+ + + +-+-+ + + + +
|   | |  #| | |# #|# #|         |   | | |
+-+ +-+-+ + +-+ +-+-+ +-+-+-+-+-+ + +-+ +
| | |    # # # #  | |# #  |       | |   |
+ + + +-+ +-+-+-+-+ +-+ +-+-+ +-+-+ +-+-+
| |     |   |     |    #      |   | |   |
+ +-+-+ +-+-+-+ +-+-+-+ + +-+-+ +-+-+ +-+
| |   |     | |# # # # #|   | | |   |   |
+ +-+ + + +-+ + +-+-+-+ +-+-+ + + +-+-+ +
|   | | |   |# #    | | |     |         |
+ +-+ +-+-+-+ +-+-+-+ +-+ +-+ + +-+ +-+-+
|     | | |# #|   | |   | |   | | | |   |
+-+ + + + + +-+-+ + +-+ + +-+ + + + + +-+
|   |   |  # # # # # #    | |   |     | |
+-+ +-+ + +-+ +-+-+-+ +-+-+ +-+ + +-+-+ +
|   |     | |   |    # # #  |   | |     |
+-+-+ + +-+ +-+-+ +-+-+ + +-+-+ + +-+ + +
| |   | |   |     | |   |#|     | |   | |
+ + +-+-+ +-+ +-+ + +-+-+ +-+-+-+ +-+ +-+
|   | |       |   | |    #    | |   | | |
+ +-+ + +-+ +-+ +-+ +-+ + +-+-+ +-+-+ + +
| |       |   |   |   | |#|       | |   |
+ + + +-+-+ +-+-+-+ +-+-+ + +-+-+ + + +-+
| | | | |   |   |   | | |#|   |       | |
+-+-+-+ +-+ +-+ +-+ + + + + +-+-+ +-+ + +
| |   |           | |    # # #|     |   |
+ + + +-+-+-+-+ + + + +-+ +-+ +-+ +-+ + +
| | |           | |   | |   |#  |   | | |
+ +-+ +-+-+ + +-+ + + + + +-+ +-+-+ + +-+
|     | |   | | | | | |   | |#| |   | | |
+ + + + +-+-+ + + +-+-+-+-+ + + + +-+-+ +
| | | |   |     | |          #| |   |# #|
+ +-+ + + + +-+ +-+ +-+-+-+ + + +-+-+ + +
|   | | |   |     | |       |# # # # #|#|
+-+ + + + + +-+-+ +-+-+ +-+ + + +-+-+ + +
|   | | | |   |     |   |   | | |     |#|
+-+-+-+-+-+-+-+-+-+-+-+-+-+-+-+-+-+-+-+ +
Path: (0, 0) (0, 1) (1, 1) (1, 0) (2, 0) (3, 0) (3, 1) (4, 1) (4, 2) (4, 3) (5, 3) (6, 3) (7, 3) (7, 2) (8, 2) (8, 1) (8, 0) (9, 0) (9, 1) (9, 2) (10, 2) (10, 3) (11, 3) (11, 4) (11, 5) (10, 5) (9, 5) (8, 5) (7, 5) (7, 6) (6, 6) (6, 7) (5, 7) (5, 8) (6, 8) (7, 8) (8, 8) (9, 8) (10, 8) (10, 9) (11, 9) (12, 9) (12, 10) (12, 11) (12, 12) (12, 13) (12, 14) (13, 14) (14, 14) (14, 15) (14, 16) (14, 17) (14, 18) (15, 18) (16, 18) (17, 18) (18, 18) (18, 17) (19, 17) (19, 18) (19, 19) 
Length of path: 61
Visited cells: 328

